-------------------------------------------------???????-------------------------o---------B------------------------------------------------------------------------------------------------------------
-------------????????------------------------------------------------------------?----------------------------------o--??????--------------B------------------------------------------------------------
-------------------------------------------------------------------------------------------XXXX--o------------------------------------------------------------------------------------------------------
---------------------------T---------------------------------------------------------------------------X-o-----------------------------------------------------------------------------------o----------
---------------------------|---------X--------X-----------------------------------------?---------------T-------------------------XB--------?-----------------------------------------------------------
---------------------------|--------XX-------XX-----------------------------------------X---------------|------------------------XX---------------------------------o-----------------------------------
---------------------------|-------XXX---X--XXX-----------------X---------------------------------------|----------------------XXXX----------------------o------------------------B---T----o------------
----o----------------------|------XXXX---XXXXXX----------------XX-----------T---------------------------|----------------------XXXX----------------X------------X---------------------|----------------v
---------------------------|-----XXXXX---XXXXXX---------------XXX-----------|--------------------X------|------------------o--XXXXX---------------XX----------------------------------|----------------f
---------------------------|T---XXXXXX---XXXXXX-----------X--XXXX--TXXX-----|-o-----------------XX------|--------------------XXXXXX--------------XXX---------------------BBBB---XX----|----------------f
---------------------------||XXXXXXXXX--XXXXXXX--------T-XX-XXXXX?-|?-------|----X------------XXXX------|-------------------XXXXXXXX------------XXXX--------X---------------o---------|------o-----X---f
---------------------------||-XXXXXXXX-XXXXXXXX--------|XXXXXXXXX--|--------|----XX-----------XXXX---o--|------------------XXXXXXXXXX----------XXXXX--------XX------?-----X-----------|-----------XX---f
-------------B-------------||XXXXXXXXXXXXXXXXXXXXXX----|XXXXXXXXX--|--------|----XXX--o------XXXXX------|-----------------XXXXXXXXXXXX--------XXXXXX--------TXX-----------XX----------|----------XXX---f
---------------------------||XXXXXXXXXXXXXXXXXXXX-----X|XXXXXXXXX--|--------|----XXXX-------XXXXXX------|----------------XXXXXXXXXXXXXX------XXXXTXX--------|XXX----------XXX---------|---------XXXX---f
m---------------------E----||XXXXXXXXXXXXXXXXXXXXX---XX|XXXXXXXXXo-|--------|--E-XXXXX----EXXXXXXX-o----|--------E-E----XXXXXXXXXXXXXXXX----XXXXX|XX---E----|XXXX-E-E-----XXXX---E--E-|---E-E--XXXXX---X
XXXXXXXX------XX-----XXMXXX||XXXXXXXXXXXXXXXXXXXXXXXXXX|XXXXXXXXX--|XXXXXXXX|XXXXXXXXXXXXXXXXXXXXX--XXXX|XXXXX-----XXXXXXXXXXXXXXXXXXXXXXXXXXXXXX|XXXXXXXXXX|XXXXXXXXXXXXXXXXXXXXXXXXX|XXXXXXXXXXXXXXXXX
