--------------------------------------------------------------XXX---------------------------M-----------------------------------------------------------------------------------------------------------
----------------------------------------------------------------o------------------------------B--------------------------------------------------------------------------------------------------------
------------------------------------------------------------------------------------------------------------------------------------XXXXXX---------------------X----------------------------------------
--------------------------------T-----------------------------------------------------------------------------------------------------------------------------------------------------------------------
--------------------------------|-----T---------T---------------------------------T------------------------------?-----????????----------------------?-------------------------------T------------------
----o---------------------------|-----|---------|----X-B--------------------------|--------------------o--------?------------------------------------------------------------M-------|------------------
--------------------------------|-----|---------|------X------------B-T-----------|--?----------------------------------------------????????----------X---X----XXXXXX----------------|------------------
--------------------------------|-----|---------|------XX-------------|-----------|----------------------o--------------------------T-------T---------XX-XX--------------------------|-----------------v
-----o---------------T----------|-----|---------|------XXX------------|-----------|-------------------------------------------------|------X|---------XXXXXT-------------------X--XX-|-----------------f
---------------------|--X-------|-----|---------|------XXXX----X------|-----------|-------------------------------------------------|---X---|---------XXXXX|------------------XX-----|-----------------f
---------------------|-XX-------|-----|---------|------XXXXX--XX------|-----------|--------------X------------XX---X----------------|---XX--|---------XXXXX|-----------------XXX-----|---------X-------f
---------------------|XXX-------|-----|---------|--M---XXXXXXXXX------|-----------|-------------XX-----------XXXX-------------------|---XXX-|--------XXXXXX|----------------XXXX-----|---------XX------f
---------------------|XXX-------|-XXXX|XXX------|------XXXXXXXXX------|--------T--|---M--------XXX----------XXXXXX-----------------T|---XXXX|-------XXXXXXX|X-BB--X--------XXXXX-----|---------XXX-----f
--------------------X|XXX-------|TX---|---------|------XXXXXXXXX---BBB|BBBB---M|--|-----------XXXX---------XXXXXXXX----------------||---XXXX|------XXXXXXXX|XX----XX------XXXXXX-----|---------XXXX----f
mE-----------------XX|XXX-------||X---|------E--|E-----XXXXXXXXXE----?|?????---|--|---E------XXXXXE-------XXXXXXXXXX-------------XE||---XXXX|X----XXXXXXXXX|XXX---XXX----XXXXXXXE----|---------XXXXX---X
XXXXXXXXXXXXXX--XXXXX|XXXXXXXXXX||XXXX|XXXXXXXXX|BBBXXXXXXXXXXXXXXXXXX|XXXXXXXX|X-|XXXXXXXXXXXXXXXXXXXXXXXXXXXXXXXXXX--XXXXXXXXXXXX||XXXXXXX|XXXXXXXXXXXXXX|XXXXo-XXXX--XXXXXXXXXXXXX|XXXXXXXXXXXXXXXXXX
