-----B??-------o---XX---?B?X-o--------------------------------------o-----E-------XX------------------M-------------------------oBXBXX-------B--X----------E-------------------------E---B?-------------
-------o---------?-B---------------------------BB-------------------o----------E---X----------------E--------------------o-----------X---------------MB-o---------X--X-BBXMBo--------BX---------------?-
-----XX------------E------------X----B?-------XX------------?----------------------o-o-------------------------?----o-B?BB---B------MB--------------------X-BB??Xo--------?BX---------X-----------------
------?MBB-BBBXX----------o-----o-----------XXX-------o-?B?-------------------------------BB------E-E---------------XB??B-o---------------X-X---------------BBBBBX---------o----------o---?XX--?B-------
---o----XX-?XB--------------------B--------BB---------------------------------MBBXBE-----------------BB-------o--?BBBXB-B?--BBX---??B-XBXE--------------------------BB------------------------------E---
--o------BX---------------------------------------o-----o---BBBX----------BB-X-?BB--B---T---B--BXXo--o------------o--BX------------o---------E------------------E-------------MB-----------X?BBB--------
--------?Xo---o------?X---o-------------------------BB------------------o---------------|-X-------?BBB--------B?BBXX--------------B-?----BBE-------------?E---o--------BBXBBX----------o--o-------------
-------XXX-B-B------XXX?-B?XB---------------o-------------MXB-X--BM?-o-BX-X----E---MB---------E-----------BBBX--------------------------------BB???----------BX-------o--------X----------------------v-
-----o---BBX--------X---------------M-----?B---------------X---BBB----------------o------XX---------o----?Bo-X--------------o-X--BXX----?-MBX-----?BX------ooo---------BBBBB-??-XX----?E---o---BX--X--f-
----o-------o-o----o-------------o---------------------Bo-??BBBB?------------X--B?o--X--o--BB?X-BX----------------B--o-----oo---------------B?-B?B?XX---------------?B----BX----XXX--------X--XX------f-
---o-?XBBB-------o---------BXX-------E-----E--------E--------------------X--X??-----XX------o-----BB?MBX----BXB?BB-----------------------MX-----X-X---------o------o-------o--o--XXXo---?BX---BB?-BX--f-
-?X------------o------XX-BX-XT-o----------------T-------oT---------------o-MB-------MB-X-T--E-?B?---B-Bo----B--XX----Bo--------------o-o---X--TE--------------------M-BXX-------X--?M-BB-?BX------o-X-f-
-B-----B?BX-----------o---o-X|-oo-------------T-|--------|-------?--B?BX---E-o---------TX|-BB-B-o-E----o-o-------BBBX---oX------------X-------|-------EXXT-----------BX----XX---o------------BT----o--f-
--------------X--------X---XX|-T-T------------|-|X---o---|------------X-X----------?o-X|-|--XX----B-BBBBXX-------X---T-XXXXX--------o--BX--XX-|XX--X-XXXX|-TXBEo------XMX---MXX-X-XXX-----E-Xo|-------f-
m--XXXXXX-XXXXX----XXXXXX---X|-|X|---o-XX-XXXXXXXX--XXXXXXX----------XXXX-XX-BXXo-XXXXXXX|-EXX--XBXXXX-o----XX-XXXXXX|-XXXXX-X-?X--XXXXX----o-|XXXXX-XXXXXX|X-XX-T----XXoX-XXXXXXXXXX----M--XXXX-X----f-
XXXXXXXXXXX-XXX--X-XXX--XXXXXXXXXXXX-X--X--XXXXXXXXXXX-XXXXXXX-XXXXXXXXX-XXX-X-XXXXXX----XXXX-XXXXXXXX-XXXXXXX-XXXXXXXXX-XXXX--X--XXXXXXXXXXXXXXX--X-XXXXXXXXXXXXXXXXX-XXX-XX-X-X--X-XX-XXXXXXXXXX-XXXXX
