-----------------------?-------------M----------------------------------o-------------------?----------------------------------------------o-----------------------------------------------M------------
----------------------------------------------o----------------------------------------------------------------------------------------------B-------------------------------BBBBBBB--------------------
---------------------------------------------------------------------M----------------------------------------------------------------------------------------------------------------------------------
------------------------------------o----------------o------------------------------?-------------------------------------------------------------------------?-------------------------------B---------
-------------------------------------------T---------------------------------------------o------------------------------------------------------------------------------------T-------------------------
-------------------------------------------|------------------------------------?----------------------------------------------------------------------o----------------------|-------------------------
----------------------T--------------------|------------------------------------------------------------------M-------------------------------------------------------o------T|--------------o----------
------X---------------|----o--------------B|---------X------------------------------------------------------------X---------------------------X------------------------------||-T----------X------T----v
-------------X--------|-----------------o--|--------------------------------------o------------------------------XX--T-------------------------------------------------------||-|------???XX??----|----f
------------XX--------|----------T---------|----------------------------??-------------------T------------------XXX--|-----------------T--XXXXXXX---------------------------T||-|--------XXX------|----f
-----------XXX--------|----------|---------|----------------------BBBBBBBB--------X???????---|-----------------XXXX--|----BBBB-?-------|------------------------------------|||-|-------XXXX------|----f
----------XXXX--------|----------|---------|---------------------------o---------------------|----------------XXXXX--|BB----------?----|------------------------------------|||-|------XXXXX------|----f
---------XXXXX--------|----------|---------|------------------------oXXXXXXX-----------------|--T------------XXXXXX--|---X--T----------|-------------------------------?----|||-|X----XXXXXX--T---|----f
--o-----XXXXXX--------|---X------|---------|-----X----------------------------------BB???????|--|--X--------XXXXXXX--|--XX--|----------|------------------------------------|||-|X---XXXXXXX--|---|----f
mo-----XXXXXXX----X---|-------E--|---o--B--|----XX-----------E--------------------E-E-E------|--|--E-------XXXXXXXX--|-XXX--|-------X--|-----------X----E-------------------|||X|X--XXXXXXXX--|---|---EX
XXXXXXXXXXXXXXXXXXXX--|XXXXXXX---|--------X|XXXXXXXXXXXX---------XXXXXXXXXXXXXXXXXXXXXXXXXXXX|XX|XX-------XXXXXXXXXXX|XXXXXX|XXXX--XX--|--XXXXX----X---XXX------XXXXXXXXXXXX|||X|XXXXXXXXXXXXX|---|--XXX
