--------o---o--------------------------------------E--o-------------BBXB??-------------E-------------------------------BBBB??X-----------E---o-MB-----------??----------o-------------------------------
--------BB?B---------------o-----E------------------------------?X----BBBB-----------BB?BBo---------------------------?BB--B-?-------E---------------------------------o------------E----------?-XX-----
-------E--------------o---B-------------------?X---------E-------------BBX----BBX-o------------o------------B?----o-----------------------E--------------------------------------BBX-------o------XX----
--BB-B--?-XXB-----------------------BBX----------------B----------------o---------------o-----------------------?-BXBB?--E---------------------------------BB----oo---------------------BXX?B-----------
-----------X--o-------E-?BBBB-------------BB-BX--------------------------------------------------X----------X-BB?----------o-X-------?XX----o---------------E--------------------------?BXBB?----MXX----
-------o-XB-------------------o---B-BX--------?BB?----------XX--------E-----o------o----------?XXX----------BBBB------------o--------o----------------BB?-------X-----BB?X--E---------------------------
--------o-----?BB?-BBX-----B------------?B?X-----------------o--------XX-B-------BBB--Bo-------X--B-B------------o------XX-------------------------------------BBMB---?B?B---?BX-----------X-------X----
-------X-?--------------X----B?X------------o-----XX-X---M---X--?BBX--X-X-------------X-------E---------BBBXX-----------E-----------------------------------------------------------------------------v-
---BB--B?BBB---------BBXX--X-B??--o-o--E--Boo----E-XBX-------E---??X---XX-----------XXXX-----------o------X--BXX-------X--------------XX-o----X-XX----XX----------X----------------Xo-X----------BX-o-f-
---------o---MB---X----BBBoX---------?XX-E----------X--------------o----o----X-----X--XXX-X----o-------E--o------------o---o------------Xo--X--BXXXB-XXXo---------XX----E----E------oo---o-------E----f-
---o----B?-------o---------BXX---------------oo-----E---------------B??B---XX-------XXX--X--o--X----?------------------------------------X------X------E-----------o-------o--o--X--o---------B??X-X--f-
---------------BBBB-----BBX--X------B-----?--X---------o---?-BBB------------o---------X--E-X----BBBX----------------------BB?XB---o----?---------X--------------o---o--------BBXXBX----o-X------o---o-f-
-----------Xo----------XXX--o----X---T--o---o--------o-o----------BX-----------------X-o---M-o------E------o---------------------------------------BBB?X-----X?B----------------XX-------E--oo-------Bf-
---X---?X---X--T-------XXX-XXXEXX-B?B|---XX-----?o--B-XX---------XX------------------oX--------X-T--------T------------X--X------E---E----X-----T---o----o-X--o-X----o---X-------X--XX---T----Eo-T----f-
m---X-XXXX--E--|--X---XXXXXXXXXX-----|-XXXX-X?B---XXX?XX-X-?X--BBXX----X-T-X--------XXX--MXXXXXX-|-ooXX---|--X--TXX-XX--XX---oE-----?X?XXXX-----|--X--T------XXXX-Xo-XXX-Xo---XXXo---X-XX|----X-X|-?--f-
XXXXXXX-XX-XXXXXXXX-XXXXXXXXXXXX---XXXXX-XXXX--X-XXXXXXX-X--XX--XX--XX---XXX--XXXXXXXXX--X-X-XXXXXX-XXXXXXXXXX--XXX-XX-XX---X-X----XXXXXXX----XXXXXX--XX--XX-XXX-XXXXXXX-X--XXXXXXXX--XXXXXXXXXXXXXXXXXX
