----oE---------o----BBo--------X-o--------?Bo------------BB-------------------------?-?--------------BX---------------------o-E----BX----------------------o-o----------E-------------------------------
---BXX---------------X------o--XXX--------------XX-------------------------------o----------o-----------------o---------------------E---------?---o-------------------------MX-B??X---------------------
-------------------?X------BB----------------MB--B---BX----------o--------------------------o---------E-------M-------------X--------B-X----------------o---B-X--X----------------------------o------o--
-----E-X-X----------------------X----------------------BBB?X-----------------BB-------XXBB-------------BBX-------------------XXX---?X--XX--------X-----M------o-E-------------XX-------E-----------X----
------------BBB-----------------B?--X-----BBXX----------------------------------E-BE-E--?BMMX-----------------o-----------?XX-X----B-----------------------E---------B----------------------------------
---------EX--------------------------T-----------Eo-----oMBBM---o?X--E------------BXX-B??BX-BX----o----------MBBXMBX-----------X-------B?B----------------------E---------------------------------------
-------------------------------------T-o---------------BXX---------------o-BBX------------------B?X--BB---BXX----o-----T-------E-----------------------------------XXB-----------E-------E-----?-B?-----
------------o----------E-------------|------X?X---------E----------------X---E-------BXX------------o-------------------------o------------B------XX---X-----------Eo----?X-BBBBX------------?MB------v-
-----o-----X?X-------XX?-------------|XX-----??-----------------?BB?--------------o-----X-XX--------o------o-------E---XX---o--B-BBBB?X-?BBX---BBB?BX-BX---ooo----X------X-B-BBB----B---MBBo---X------f-
------o--?--oE---------XX-----------XXX----o------------?BBB--------B-XX----------------E--oo------------?BXX--------M?X---o-------MBBX----?XB-------BB-B?B-B?BBBE--------BBBB----------------------?-f-
----?o---------o--E----X-----------TXXX??-XXo---------Bo--------o-----------o-----X-----X--?B-B----X-B----E-?B?BB-----X----XX---o----BBBX--o-----------X---------o---------------o--B-?X----------o---f-
---BBB---------o------MXB?BBo--------XX----B------------------B-------B-BB----BB-X--?Boo-------------------o---|-----Bo-----X-------E----o--o-X--------?--MB--MBB------------o---?MBB?-BBXX----------Mf-
-----------------------X------------X---------------XT-E---?B-X-------o---BX--------MB-X-----XX--------Xo-----?|X---B??-BX-o--------o----------X-------------BB------E----------------------X--E------f-
---------XXX-----------X---------o--XX---------?-----|-o-X?X---------------X-----BB-----T---XXXX---BBBX-X---X--|X---B-?X---X--T---o----o---?XX-X?BX------BB-----T-------X-----------X-----X-----------f-
mX-BB----XXX-T-X-------BXT-o-----XXXXX----X-?XX-----X|-XXXX-------X--XBXX--XT-X--X------X-XXX--XX----X-XXX--XoXXXX------X?EXX-|-??XXX--XX?XBXXXXXXX---XXX-----XX|X----XXXXXX-XX--XXXX-XX--B-XXX-XT-?--f-
XXXXXXXXXX-XXXXX-X-XXXXXXXXXXXXXXX-X-XXXXXX-XXXXXXX-XXXXXXXXXXXXXXX--XXXX-XXXXXXXX---XXXXXXXXXXX--XXXX--XXXXXXXXXX-X--XXX-XX-XXXXXXX--X----XXXXXX-XX-XXXXXXXXXXXXXX-XXXXXXXXXXXXXXX--XXX----XX-XXXXXXXXX
