-----BB------------------B?BB?X-----------------------------------------o--------------?B-----E------o---------?---M-B--------------------------E--XXXX---XX?-?B-------------------?--------------------
-----------------?B---------------o-----------------------X-----------------------------------------o-o---------------------E--------E---o------M-B--------E-----------------------------------o-----?--
-----o---------------------BBBB----X----------------------o-------BX-o-------------------------------E------------------?B?-------------?X-BBB----------------B?B----------??o----------?-o-------------
--------------------------------MXX---BBB----------------------??------------------------X-?---------------------------BB?XXE--E------o-----------Eo-----------------E-?--------------X----B-XX---------
-BB-BBB----XXX-----o----------------E-----------------------------------E--------------------------------------------E-----B-BB-------XX-------------E--o----oo------------------------BX---------------
---------MBXX-------------------------E----?-XX-------------?BBBB---------B-----------------------?BXX----------------B-XB----X--o-----o--??XXB--------------------XX------------------o----------------
--------------------------T------------o------X--------B-----------------o---------------------XB-BXX----BB------o----------------------------------X--X-E---o----XBX------------E-------E-----??-B-----
------------o-----X-------|-----------------XXX------X---------------------X---------BXX------------o-------------------------o------------B?B------X--X-----------E-----?-X---BB---------------------v-
----o------------M------X-|---------------?XX?BBX--XXX-------------X-----XX---o-XBB----o-----?BXXB--E-------B-B-------------------B-X-X--------------?-X-X-------------------------------------------Xf-
---------o----E-----XEBB?X-XX---------------XBB??BX-X--------------o----o----X-XX-----BX---XX--o----------o------------o---o----------M-XX----oBBBBB----o---------XX---------E------oo---o-------E----f-
---o------?B-----o----------XoXX---E---------oo-----E-----------E-----------X---X-----------o--X-B---------------------o---------------------------------X---------o-------o--o--X--o---------BBX-XX--f-
-----------?X--------------XXXX---BX-------------X-----o------BBBB---------o?BB-XXMX--------o--Bo-o------B-o---------?XX----X----E-BX-------?B------T----B-----------------------BBMX?X-------X----B--f-
-------X------------------XX--X------XBBE--------o--X-X---|-?XX?BB-----XX------E--X------XXX-----------oX--------------XE---o------------o---T----------X-------------XX-?B----------------?B?XX-----of-
-----XXX------------o---X-----X-E-?XX----?o---XX-XXXXXX---|XXXXXX---o--o--o-----------MBBB-BX---E-----XXX-E---X-?XBXXX-X-o-BB?-X-X-XX-------X--EX--o--X-XoBX--X-----oX--------------XE--BMo--------X--f-
m---XXXXX-XM----XX-X--XXXXXX-----XXX-----------XX-XX-XX?XX|XXXXX--o-Xo-----T-XBXX-XX-X----BX?XT-X-XXXMBX-XXo-XX-----XXXXX---XXXXXXXXXBT--XXXXX-XXX-XX?-X--XXXXX-XXXEXo-XXXXXX-XX-B??XXXX---X---oE-XX--f-
XXXXXXXXXXX----XXX----XXXXXXXXXXXXXX-XXXXXXXXX-XX-XX--X-XXXXXX----XXXXXX-X-XXX-XXXXX-X--XXXX-XXXX-XX--XX-XXXXX--XX--XXXXXXXXXXXX-XXXX-XXXXXXXXXXXX---XXXXXXXXXX--XXXX-XX-XXXX-XX-XXXXXXX-XXXXXXXX-XXXXXX
