-------o------------------------------------------------------------------------------------------------------------------------------------------------------------------------------------------------
---------------------------------------------------------------------------------------------------------------------------------------------------------------------------------------------B----------
--------------------------?-----------------------------------------------o-----------M-----------------------------------------------------------------------------------------------------------------
-----------------------------------------------------------------------------------------------M-----------------------X---X-----------------------------------T-----B----------------------------------
------------------------------------------------------------------------XXXX-----------?-----------------------------------------------------------------------|----------------------------------------
-------------------------------------------------------------------------------------------------------------------------B-------------------------------------|----------------------------------------
---------------------------------------------------------------------------------------------------------------------------------------------------------------|--X---------------------X---------------
-----------------T-----------------------------------------------?-------------------------------B-------------------------------------------------------------|--XX---------------BBBBXX--------------v
----X------------|------------------------------------------------------------------------?---------------X------------------------T-------------?X?-----------|--XXX-----------------XXX-B------------f
-----------------|------------?-------------------T----------------------------------------------------------------------B---------|--------------XX--X--------|--XXXX-----T---------XXXX--------------f
-----------------|--------------------------------|--------------------------------------------------------------------------------|--------------XXX-XX-------|--XXXXX----|--------XXXXX-------?------f
-----------------|---------BBBBBBBB---------------|---------------------------------------------------------------------------X----|----X---------XXXXXXX------|--XXXXXX---|-------XXXXXX--------------f
-----------------|---T----------------------------|----------------------------------------------XXXXXXX---------------------------|--------------XXXXXXXX-----|XXXXXXXXX--|------XXXXXXX--------------f
-----------------|---|-----B----------------------|--------------------------------------------------------------------------------|--------------XXXXXXXXX----|--XXXXXXXX-|-----XXXXXXXXX-------------f
mE--E----------E-|---|---------------E------------|-----------E---------------------------------------X----------------------------|-----B--------XXXXXXXXXX---|--XXXXXXXXX|----XXXXXXXXXX-------------X
XXXXXXXXXXXXXXXXX|XXX|XXXXXXXXXXXXXXXXXXXXXXXXXXXX|XXXXXXXXXXXXXXXXXXXXXXXXXXXXXXXXXXXXXXXXXXXXXXXXXXXXXXXXX--------XXXXXXXXXXXXXXX|XXXXXXXXXXXXXXXXXXXXXXXXXXX|XXXXXXXXXXX|XXXXXXXXXXXXXXXXXXXXX------X
