--------------------------------------------------------------------------------X-----------------------------------------------------------------------------------------------------------------------
------------------------------------------------------------------------------------------------------------------------------------------------------------------------------------------------------B-
-----------BBBBBBBB------------------------------------------------------------------------------------BBB----------------------------------------------------------------------------------------------
-----------M-------------------------------------------------------------------------------------------------------------------------o--------------------X-------------------------------T-------------
------------------------------------???----------------------------------------------M-------------------X--------------------------------------------------------------------------------|----?--------
------------X------------------------------------------------o--o---------------------------------------XX--------------------T--------------------------T------------------------T-------|-------------
----------?-XX---------------------------------o---------------------------X-----------X--XXXXXXX------XXX--X-----------------|--------------------------|-----------------------B|-------|-------T-----
------------XXX--------------------T-----------------T----B----------------XX--------X-XX-------------XXXX-XX-M-o-------------|------------T-------------|------------------------|-------|-------|----v
------------XXXX-------------------|-----------------|---------------------XXX-------XXXXX-----------XXXXXXXX---------X-------|------------|-------------|-------------------o----|-------|-------|----f
------------XXXXX-------BBB----o---|-----------------|------------X--------XXXX---T--XXXXXX---------XXXXXXXXX--????-----------|-----------X|-------------|---------------X--------|-------|--o--B-|----f
------------XXXXXX-----------------|------o----------|------------XX-------XXXXX--|--XXXXXXX-----X-XXXXXXXXXX-----------------|------X---XX|----------X--|--------------XX--------|--?----|-------|---Mf
------------XXXXXXX----------------|--------------o--|------------XXX------XXXXXX-|--XXXXXXXX----TXXXXXXXXXXX-----------------|---------XXX|------B------|-------------XXX--------|-------|-------|----f
------------XXXXXXXX---------------|-----------------|------------XXXXBBBBBXXXXXXX|--XXXXXXXXX---|XXXXTXXXXXX-----------------|--------XXXX|-T-----------|------------XXXX--------|-------|-------|----f
---------T--XXXXXXXXX--------------|-----------------|---X--------XXXXX----XXXXXXX|--XXXXXXXXXX-X|XXXX|XXXXXX-----------------|---T---XXXXX|-|-----------|X----------XXXXX--------|-------|-------|----f
m--------|--XXXXXXXXXX-------------|---------E--XX---|---XX-------XXXXXXE--XXXXXXX|X-XXXXXXXXXXXX|XXXX|XXXXXX-------B---------|---|--XXXXXX|-|---E-----E-|XX--------XXXXXX--------|-------|-------|----X
XXX--XXXX|--XXXXXXXXXXX--XXXXXXXXXX|XXXXXXXXXXXXXXXXX|-XXXXX---XXXXXXXXXXXXXXXXXXX|XXXXXXXXXXXXXX|XXXX|XXXXXXXXXXXXXXXXXXXXXXX|XXX|XXXXXXXX|X|XXXXXXXXXXX|XXXXXXXXXXXXXXXX--XXXXXX|XXXXXXX|XXXXXX-|XXXXX
