-----------------------------------X-----------------------o------------------------BB-------------------------------------------------------------------------XXXXXXXX---------------------------------
--------------------XXXXX--------------------------------------------------------------------------------------------------------------------------------------o--------------------------------X-------
----X-----------------------------------------------------------------X-------------------------------------------XXXXXX------------------BBBBB---------------------------------------------------------
--XXXXXoX---------------------------------------B-------------------------------------------------------------------------------------------------------------------------------------------------------
----------------------------------------------------------------T------------------------------------------------------------------X-------------X----------------------------------XX------------------
-----------------------??-----?---T---------X-------------------|----------X--------------------------------BBBBBBBB-----------------------------------------T------------------------------------------
---X?-------X---------------------|--------XX-------------------|---------XX------------------???o???----------X------------------?--------------------------|------------BBBBB-----T-----X-------------
---XX------M----------------------|-------XXX-----------------X-|--------XXX----------------------------------XX---X-----------------------------------------|----------------------|------------------v
---XXX-??????T----------------X---|--X---XXXX----------------XX-|-------XXXX---M-----------------------------XXX--XX----------?-----------------T------------|----------------------|------------------f
---XXXX------|----------------XX--|-XX--XXXXX---------------XXX-|--BB-TXXXXX------o-----X-------------------XXXX-XXX-----------X------------T---|------------|------T---------------|-----------------Xf
--MXXXXX-----|X------?--------XXX-|XXX-XXXXXX--------------XXXX-|-----|XXXXX-----------XX???????---------X-XXXXXXXXX------------------------|---|------------|--B---|---------------|----------------oXf
---XXXXXXB---|----------------XXXX|XXXXXXXXXX---X---------XXXXX-|----X|XXXXX----------XXX--X------------XXXXXXXXXXXX------------------------|---|------------|------|---------------|-----------------Xf
---XXXXXXX---|-B--------------XXXX|XXXXXXXXXX--XX------T-XXXXXX-|---XX|XXXXX---------XXXX-XX-----------XXXXXXXXXXXXX------------------------|---|------X-----|------|---------------|-----------------Xf
---XXXXXXXX--|------o---------XXXX|XXXXXXXXXXoXXX------|XXXXXXX-|--XXX|XXXXX-o------XXXXXXXX---B------XXXXXXXXXXXXXX-----------------T------|---|-BBBB-------|-----B|---------?-----|-----------------Xf
mE-XXXXXXXXX-|---o--o---------XXXX|XXXXXXXXXXXXXX------|XXXXXXX-|-XXXX|XXXXX-------XXXXXXXXX----X--EEXXXXXXXXXXXXXXX------E--E-------|------|---|------------|------|--------E--E--E|-------E--E-----XXX
XX-XXXXXXXXXX|----XXXXXXXXXX--XXXX|XXXXXXXXXXXXXX----XX|XXXXXXX-|XXXXX|XXXXXXXXXX-XXXXXXXXXX-XXXX---XXXXXXXXXXXXXXXXXXXXXXXXXX-------|XXXXXX|XX-|XXXXXXXXX---|XXXXXX|XXXXXXXXXXXXXXX|XXXXXXXXX------XXXX
