----------------------------------------------------------------------------------------------X----------------?----------------------------------------------------------------------------------------
------XX------B--------------------------------------------------------------------------------------------------------------------------------------------------B---------------------XXXXX------------
------------------------------o----------------------------------------------------------------------------X--------------------------------------------------------------------------------------------
-----------------?o----------------------------------------------M-------------------------------------M------B---------o-------------------------------------------------------------------------------
------T-----------------------------X------------------------------------------------------------------X-----------------------------B--------------X-------------------------------M-----------T-------
------|-----------?----------------XX-----------------------------------------------------------??????XX-------------------------------------------XX-X----------------------------------XX-X---|-------
------|---------------------------XXX---M-------------X------------------------T---------------------XXX----------------T-----------??------------XXXXX----------------------------------XXXXX--|-------
------|-----------------------o--XXXX-----------------XXX----------?-----------|--------------------XXXX----------------|T-----------------------XXXXXX------------M---------------------XXXXXX-|------v
------|-------------------------XXXXX--B--------------XXXX---------------------|-------------------XXXXX----------------||-X--------------------XXXXXXX-o-----------o--------------------XXXXXXX|------f
---o--|T-----------------------XXXXXX-----T-----------XXXXX--------------------|------------------XXXXXX----------------||XX--------B----------XXXXXXXX------X---------------------------XXXXXXX|------f
------||-------------T--------XXXXXXX-----|X----------XXXXXX-------------------|-------o---------XXXXXXX---------------M||XX------------------XXXXXXXXX-----XX--------------------o------XXXXXXX|X---T-f
------||------------B|-------XXXXXXXX-----|XX---------XXXXXXX------------------|---------?------XXXXXXXX----------------||XX--------???????--XXXXXXXXXX----XXX-------------T-------------XXXXXXX|XX--|-f
------||-------------|XXXX--XXXXXXXXX-----|XXX--------XXXXXXXX-------------T---|---------------XXXXXXXXX---------------X||XX----------------XXXXXXXXXXX---XTXX-T-----------|---X--------XTXXXXXX|XTX-|-f
------||-------------|---o-XXXXXXXXXX----X|XXXX-------XXXXXXXXX-X--o-------|---|----------X---XXXXXXXXXX--------------XX||XX---------------XXXXXXXXXXXX--XX|XXX|-----------|---XX------XX|XXXXXX|X|XX|-f
m-----||--E----------|----XXXXXXXXXXX---XX|XXXXX--o---XXXXXXXXXX-----------|---|-------------XXXXXXXXXXX--------EE---XXX||XX------E--E----XXXXXXXXXXXXX-XXX|XXX|-----------|E--XXX----XXX|XXXXXX|X|XX|-X
XXXXXX||X-------XXXX-|---XXXXXXXXXXXXXXXXX|XXXXXXXXXXXXXXXXXXXXXX-----XXXXX|XX-|XXXXXXXXXXXXXXXXXXXXXXXX-M----XXXXXXXXXX||XXXXXXXXXXXXXXXXXXXXXXXXXXXXXXXXX|XXX|XXXXXXX----|---XXXXXXXXXX|XXXXXX|X|XX|XX
