----o--o-------o------o------M??XX----------o----X---------------------------------??-----------------B??X------------------o------------------------------o-o----------E-XX---------E------------E-----
-----BB-BX------?-XXX-------------------?-o------o---------------B?--BB-----o------o------------XB?-----XX------------BB---------X-----------X--BX-o------------X--o---o-X-X----------o----------MBX----
--------------------o------E-------------------------o-------o--------------------E----------------------X------------------------------X-----BXXBBX----------Bo-----BBX--MBB?X-X------------o----------
-----E-------------------------------------------------BBX----------E--------XX------------------o-----B--------------------BBX------XX-o-----BBX-BB?X---E----o---------------X-X----M-X-----------B----
------?----B??--BB?X--------------E--------BX-----MXXBX-----X-------MXX-----o----------E---BBBX-XX-----------------------------E-------------------MB-----BBX--o--M-X--------o---o------??o------?BB----
-B?-------------------BXE-------?--BBX-XX--B?--o----E----------o-X--------------o-E------X--X-BXX-E--?XB?B?---------------------o--------------------o--------------------------X-----------------------
--------o------?XX---E----B-----------E----------------------o---------?-o-----B-B--XX-o-?XXX--X---?--o-B--------o------XXXBBBB------------------E--------------------?BBBBX-BB?--X----------------X----
-------XX-B-BXB-----XX-?BX---------------X--o------------------B-BBX-----------E--------E-X---E---------BX-X------------E----------------------------------------------------X---?X----------------X--v-
----?o---X--E-------XXo-------------EBXXX-------------------------E---------B?-BBBo-----XXXX--------o-M--XXo-----------X----o----BXX--------XX-BBB?X?-BX---ooo----XB-------?-B?---o--------o---BXXXXM-f-
---------o------?B--?BX---oX----------XX---X--------X--------------o----o--?-X--------XXX-XX---o---------Xo------------o---o----------MBXX----oXX----------------BX-----------------Xo---o---?B-XE--M-f-
---o--BBB-?E-----o---------BXo-------E-----E--------E-------------M------XXXX?X-----XXX-BX-Bo-----B-?-BXXX-------------------------------X----XX-X-----------------o-------o--o--XTXX----BXXXBBB?BBX--f-
--------B------oE-BXX---B?-Bo-??X----X-----B---------?X-----XXBE---T---T-------MB--o--oo------X------------o----------o-----X-------E----o--o-X------------------------------o----|-------------------f-
-----------X--------B-X-----------?XX-X-------------XX-X-----o--------o|---X------------T---T-X---------------?XX-------E--o??------o---X-------------------X-----BB-E------------|--------EX--E-----Ef-
---------XXX-----------X---E--------XXX---X-----BBBBX----X---------T---XX--X------------|---|-XT-X-TX-X-XT--X--XX----------X-----Boo--XXX---T----T-X--MXBBT--X--T-------T---X-X---|-------XX----------f-
m?XX?----XXXXX-X----XX-BXX-X-----XXXX-----X--XX------XXXXX--XXXXX--|-XXXX--XXXXX-X-----XXXX?XXX|---|-XXXX|--XB?XX--X---XXXEXX------X---XXMXX|----|--XXXXXX|-XX--|-XXXXXX|-X-XXX--XXXXE---X--XXXE-T-X--f-
XXX--X-XXX-XXXXX--XXXXXXXXXX-XXXXXXX-XX-XXX-XXXXXXXXXXXX--XXXXXXXXXXXXXXX-XXXXXXXX---XXXXX-XXXXXXXXXXXXXXXXX-XXXXXXX--XXXXXXXXX-XXXX--XXXXXXXXXXXXXXXXX-XXXXXXXXXX-XXXXXXX-XXXXXXXX--XXXXXXXXXXXXXXXXXXX
