----o----------o------o-------BX------------o---M?------?---------------------------?BBBB-----------------------------------o-E---B-X----------------------o-o----------E---X---------------------------
----------------------------o-------------------X-------------------------------Bo----------o-----------------o-------------?B------E-------B--BXXo-------------------------M-------------X-------------
-----------------o---------B-XX------------------BB--------------o--------------------------o-------------------------------X-------BBBXBB--------------o-?B?BX--X----------------------------o---------
-----E------------------------MBX-----------------------B-------------------?--B-----MXX-------------------------------------BB?XX--X---o-----B??E-B?BBMBE----o-E-------BX-----BX------E-----------X----
-----------?B-------B-----------B?BXX----BBX-?-------------------------E----------B--E--------------M?BBBB----o-----?------------BBB-----------------------E-------B-BB???X---------E-------------------
---------EX---------------------------------------o-----o-BBMBB-o----E-----BB-----BX--B------X----o----------MX------------o---X-------BB-----------------------E--------------------------XB?BBB-------
-------o?Bo---o--E--MBXX--o------------E-o-----------------??-----------o-----------------------------XX-----X------------MBX---MB---------E-------------?E----------------------------o--o-------------
------?------X----BB-X?X-------------|-o----o-------------------?BBBB?-B-BB-B----------MB---------o-?XX---B-X--------?X|-------o-----------------------------------------------X-------------E-----?--v-
-----o-----X?X--------X--------------|XX-----?------------------?X----------------o-----X-XX--------o------o---------BXXX---o--B?BB-B?B--BBX-----B?-XXBX---ooo----X---BBBX---BB?BBB-BB-----o--B-------f-
------o--?--oE---------X------------X|X----o------------?-BB---------BX-----------------E--oo------------?BXX---------?X---o---------------?XBB------BBBB?BB?-BBXX--------B?X---------------------E---f-
----?o---------o--E----X------------XXX?--XXo----------o--------o-----------o-----XX----X----B------------E--B?T------X----XX---o-----BBX--o--X-------EX---------o---------------o-BBX-X----------o---f-
---B---XX------oE------X-BBBo--------X-----BB----------------?B?-------B------BBB--XXBoo-------------------o---------Bo-?---X-------E----o--oMXXo------?BXX---------T--------o---?MX---BBBX-----------f-
-----------------------X------------X---------------XT-E-----X--------o---BX----------X----E-XX---------o------XX---B???B--o--------o----------XX---------BX-BB?-----E----------------------X---------f-
---T-----XXX-----o---T-X------T----BX-X--T-----------X?oX-----?T-----------X----BX-BBBBXT-TXXX-----B----XT--XT-XXX---------XT-----o----o----T--XX-------B?XX----T-------T-T-XET---??BXX---XX----------f-
mXX------XXX-T-X--------XT-oX----XXXXXXX-----XX--XX-XXXXXX-X------X--X---?--T-X--X----?B---XXX-X-----X--XX--XXXXXX-X----X?EXX--X?X-X---XX-XX-|--X---|-XXXX-XXXX-----X--X-X--XXX--XXXX??XX-XXXXXBXT----f-
XXXXXXXXXX-XXXXX---XXXXXXXXXXXXXXX-X-XXXXXX-XXXXXXXXXXX-XXXX-XXXXXX--XXXX-XXXXX-XX---XXXXXXXXXXXXXXXXXXXXXXXXXXXXXXX--XXX-XXXXXX-XXX--XXX--XXXXXXXXXXX-XXXXXXXXXXX--XXX--XXXXXXXXXX--XXXXXXXXX-X-XXXXXXX
