-------------------------------BB------------------------------X----------------------------------------------------------------------------------------------------------------------------------------
-----B-----------------------------------------------------------BBB-------------------------------------M-----------------------------------------------------------------------------XXXXXXX----------
--------------------------------------------------BBBB----------------------------------------------------------------------------------XXXXXXX------------------------------XXXXXXXX-------------------
----------------------------------------------M--------------------------------------------------------------------T-----------------------------------------------------------------B-------------T----
---T--o-------------------------------M----------------------------B------------------XX---------------?-----------|---------------?----------------XXXX-------------M----------------------T-----T|----
---|-------X---------T-------------------------------------------M--------B--------????---------?------------------|---------------------------------X--------------------------------------|-----||----
-B-|-------XXo-------|----------------------------o-----------------o-------------------T------------XXXXXXX-------|-----T---------------------------XX--------------------------T---X------|-----||----
---|-------XXX-------|------------------------------------------------------------------|------B---B---------------|-----|----X----------------------XXX-------------------------|----------|-----||---v
---|-T-T---XXXX------|-------------------------?----------------------------------------|--------------------------|-----|---XX-----T-M--------------XXXX------------------------|----------|-----||---f
---|-|-|---XXXXX-----|------------------------B-----------------------------------------|-----X------------T-------|-----|--XXX-----|-------------X--XXXXX-----------------------|----------|-----||-X-f
---|-|-|---XXXXXX----|-------------?-----------------------------------------------M-X--|-----------------T|-------|-----|-XXXX-----|-------------XX-XXXXXX-----B--BB-----------M|----------|----X||XX-f
---|-|-|---XXXXXXXXB-|---------------------------------------------------------------XX-|-----------------||-------|-----|XXXXX-----|-------------XXXXXXXXXX----X----------------|--------T-|---XT||XX-f
---|-|-|-?-XXXXXXXX--|--------------------------------------o------------------------XXX|-----------------||BBoBB--|M----|XXXXX-----|-------X-----XXXXXXXXXXX---XX---------------|--------|-|--XX|||XX-f
---|-|-|---XXXXXXXXX-|----------------------XXXXXXX----------------------------------XXX|-----------------||-X-----|----X|XXXXX-----|------XX-----XXXXXXXXXXXX--XXX--------------|--------|-|-XXX|||XX-f
m--|-|-|---XXXXXXXXXX|----E--------------E-E--E---E--------E----??-------------EE----XXX|XE------E-----E--||XX--E--|---XX|XXXXX-----|--E--XXX-----XXXXXXXXXXXXX-XXXX---------E---|--------|E|XXXX|||XX-X
XXX|X|-|---XXXXXXXXXX|XXXXXX--------XX-------XX?XXX---------X---XXXXXXXXXXXXXXXXXXXXXXXX|XXXXXXXXXXXXX----||XXXXXXX|XXXXX|XXXXX-XXXX|XXXXXXXXX----XXXXXXXXXXXXXXXXXXXXX---XXXXXo-|XXXX----|-|XXXX|||XXXX
