---------------------------------------------------------------------------?-???????-------------------------------------------------------XXXXXXXX----------BBBBB----------------------B---------------
--------------------------o--------------------------------------------------------------B------------------------------------------------------------------------------X------------o-B----------------
--------------------------------------------------------------------------------------------------------------------------------------------------------------------------------------------------------
---------------------------------------------------------------------------------------------------------------B--B------------------------------M--------------------------o------------------M--------
-------------T------------------------------M---------T-------------------------------------------------------T----------------------------------------------???????------------------------------------
-------??----|----------------------------------------|------------------------------------------------------o|------------------X-------------------X----------------------------?---------------------
-------------|----------------------------------------|-------M--------------------T---o--------------------?-|-----------------XX-------?-----------XX-------------T---X-------------------------------
-------------|----------------------------------------|----------------------------|--------------------------|----------------XXX-------------------XXX------------|-T--------------------------------v
-------------|o--------------------BB----B------------|---------------------------T|--T--------X--------------|---------------XXXX-------------------XXXX-----------|-|--------------------------------f
-------------|-------------------------BX-------------|------------------T--------||--|-------XX--------------|----------XX--TXXXX--------M----------XXXXX----------|-|---------------T--------------XXf
-------------|----------------------------------------|------------------|--------||--|------XXX--------------|-------------X|XXXX-------------------XXXXXX---------|-|---------------|------X---------f
-------------|-X--------------------------------------|------------------|-----X--||--|-----XXXX--------------|------------XX|XXXX-------------------XXXXXXX--------|-|---------------|------XX-------Xf
-------------|-XX-------------------------------------|------------------|----XX--||--|----XXXXX--------------|-----------XXX|XXXX-------------------XXXXXXXX-------|-|---------------|--o---XXX------Xf
----o--------|-XXX------------X-----------------------|------------------|---XXX--||--|---XXXXXX--------------|----------XXXX|XXXX-------------------XXXXXXXXX------|-|-----------T---|------XXXX-----Xf
m-------E----|-XXXX----E-----XX--?--E------E----------|--------------E---|--XXXX--||--|--XXXXXXX--------E-----|---------XXXXX|XXXX---------E-EE--X---XXXXXXXXXX-----|-|-----------|---|------XXXXX----XX
XXXXXXXXXXXXX|XXXXXXXXXXXXXXXXXXXXXXX-XXXXXXXXXXXXXX--|-????XXXXXXXXX--XX|XXXXXX-X||XX|XXXXXXXXX--XXXXXXXXXXXX|XXXXXXXXXXXXXX|XXXXXXXXXXXX-----XXXXXXXXXXXXXXXXXXXXX|X|XXXXXXXX--X|---|--XXXXXXXXXXXXXXX
