----o--------?Xo--??X-o-------------------?Bo-----------?-?BB-----------------------?-?XE-----------MB?-X-------------------o-E----BX----------------------o-o----------E-------------------------------
-------------------E--------o------------------BXX-------------------------------o----------o--E--------------o---------------------E-------------o----------------X--?------X--------------------------
-------------------------------------------------BB---X----------oBB-------E----------------o-----------------M-------------X---------BX----------------o-?BBXX--XXX?-------------------------o------o--
-----EMX----------E-------------X-----------------------BB?-----------------?XB-BXX----XX--------------B---------------------B-?X--?X---o-----B----------BBX--o-E-------BX-------------E-----------X----
------------BB?BBB--------------B?B-X------?-------------------E-------E--------EoBE----?B?-------------------o------------X-------BX----E---------------------------BBB?BXXX---------------------------
---------EX---------------------------------------o-----o-BB-BBXB----E-------X----B---BB----------o---X-X----MX------------o-----------B------------------------E--------------------------XB-BBBB---M--
-------o?Bo---o-----MBXX--o------------E-o-----------------??-----------o-------X---------------------XXX----X------------MBXX---B---------E-------------?-----------------------------o--o--------M----
-------------X-----B-X-XX-------------------o-------------------?B-BB?B-B--BBX--------------------oMBX---BB?X--------?XX-------o-----------------------------------------------X-------------E--------v-
-----o-------X--------X---------------XX-----??-X--------E-------B----------------o-----X-XX--------o------o-----------XX---o--B?BBXB---?BBXX----B?-XXB----ooo----X---BXX-----BBB---BX-----o--BX------f-
------o--?B-oE---------X------------XXX----o------------?BBBB-------BB------------------E--oo------------?BXX--------M?X---o---------------?XBBBX----BBB-?BB--B-XX--------B-----------------------E---f-
----?o---------o-------X------------X?X?--XBo---------BoT-------o-----------o-----XX----X--?-B-----X------E--B?-------X----XX---o----B--X--o--X--------X---------o---------------o--B--X----------o---f-
-------XX------oE----T-X-T-Bo--------X-----BBX----------|----?B?-------B--------BX---Boo-------------------o---------Bo-?---X-------E----o--oMXXo------?BXX------------M-----o---?MX----B-------------f-
---------------------|-X-|----------X---------------XT-E|----XM-------o---BX-----------X-----XX---------o------XX---B?-?BB-o--------o----------XX-----?B--TX-BB------E--------------------------------f-
---------XXX---------|-X-|----------XX---------?-BX-B|-o|------------------X----BB------T----XXXX---B---X---X--XX---B-?X---X--T---o-X--o---??X-X?-------BB|-------------------------------X---X-------f-
mXBBBX---XXX-T-X-------BXX-o-----XXXXX----X-?XX|--X-X--XXX|-------X--XBXX--XT-XX-X------|-XX|--XXX---X-XXX?-XoXXXX------X?EXX---??XXX--XX-XBXX--XXXX--XX--|---XXXX----XXXX|XXXX--XXXX--X----XXX-XT----f-
XXXXXXXXXX-XXXXX-X-XXXXXXXXXXXX-XX-X-XXXXXX-XXXXXXX-XXXXXXXXXXXXXXX--XXXX-XXXXXXXX---XXXXXXXXXXX--XXXX--XXXXXXXXXX-X--XXX-XXXXXXX--X--XXX--XXXXXX-XXXXXXXXXXXXXXX-XXXXXXXXXXX-XXXXX--XXX----XX-XXXXXXXXX
