---------------------------------------------------------------------------------------------------------------M----------------------------------------------------------------------------------------
-------------------------------------------------------------------------------------------------------------X------------------------------------------------------------------------------------------
-----o-------------------------------------------------------------------------------?------------------------------------------------------------------------------------------------------------------
-------------X--------------------------------------------------------------------------------------------------------------------------------------------------------------------------M---------------
--------------------------------------------------------------------------------------------------------------------------------------------------------------------------------------------------------
------------------------------------X-----T-----------------------------------------------------------------------------------------------------------------------------------------------X----???????--
-----------------------------------XX-----|------------------------------------M-T----BB---------------X------------------T----------------------------------------X----------------------XX------------
----------------------------------XXX-----|--------------------------------------|--------------------XX------------------|---------------------XX----------T-------X---------------------XXX----------v
---------------------------------XXXX-----|----------X----------------o----------|-------------------XXX-------------o----|---------------------------------|-------XX--------------------XXXX---------f
--------------------T-----------XXXXX-----|----------XXB--------o----------------|-T----------------XXXX------------------|---B-----------------------------|-------XXX-------------------XXXXX--------f
--------------------|----------XXXXXX-----|----------XXX-------------------------|-|---T-----------XXXXX------------------|--o------------------------------|-----X-XXXX-------??????-----XXXXXX-------f
--------------------|---------XXXXXXX-----|----------XXXXBBB--o------------------|-|---|----------XXXXXX------------------|---------------------------------|??--XX-XXXXX-----------------XXXXXXX------f
--------------------|--------XXXXXXXX-----|----------XXXXX-----------------------|-|---|---------XXXXXXX------------------|----------------------B----------|---XXX-XXXXXX----------------XXXXXXXX-----f
---T----------------|------MXXXXXXXXX-----|----------XXXXXX----------------------|-|---|BB------XXXXXXXX------------------|---------------------------------|--XXXX-XXXXXXX---------------XXXXXXXXX----f
m--|------M---------|------XXXXXXXXXX-----|---E--M---XXXXXXX---------------------|-|---|-------XXXXXXXXX------------------|---------------------------------|-XXXXX-XXXXXXXX------------E-XXXXXXXXXX---X
XXX|XXXXXXXXXXXXXXXX|XXXXXXXXXXXXXXXXXXXXX|XXXXXXXXXXXXXXXXXXXXXXXXXXXXXXXX-----X|X|XXX|XXXXXXXXXXXXXXXXXXXXXXXXXXXXXXX---|XXXXXXXXXXXXXXX-----XXXXXXXXXXXXX|XXXXXXXXXXXXXXXXXXXXXXXXXXXXXXXXXXXXXXXXXXX
