--------------------------------------------------------------------------------------------------------------------------------------------------------------------------------------------------------
--------------------------------------------------B------------------------------------------------------------------------------------------------------------M----------------------------------------
----------------B------------------------------------------------------------------o-------------------------------------------------------------o------------------------------------------------------
-----------------------------------------------------------------------------------------------------------------------------------------------o--------------------------------------------------------
-----------------------------------------------------------------------------------------------------------------------------------------------------------X--------------------------------------------
--------BBBBBBB------------------------------------------------------------------?????-----------B--------------------------------------------------------XX--B------------------------T----BBBBBX------
--------------M------o----------------------T------------------------------B-------------------------------------------------------------X---------------XXX----------------????????---|----------------
-----------o--------------------------------|------------------------------------------------------------------------X-X----------------XX--?-----------XXXX---------------------------|---------------v
--------------------------------------------|---------------------------------------------X---------X---------------XX-XX-----------BBBXXX-------------XXXXX--------------------X--X---|---------------f
----------------?---------------------------|------------------------X-----------X--------XX--------XX-------------XXX-XXXM-----------XXXX------------XXXXXX--------------------XX-XX--|--------------Xf
------------?---------X---------------------|---------X--------B----XX-----------XX-------XXXo------XXX-----------XXXX-XXXX----------XXXXX-----------XXXXXXX--------------------XXXXXX-|-----------X--Xf
----------------------XX-T------------------|--------XX------------XXX------X----XXX------XXXX------XXXX---------XXXXX-XXXXX--------XXXXXX----------XXXXXXXX--------------------XXXXXXX|-----------XX-Xf
----------------------XXX|------------------|-------XXX-----X-----XXXX------XX---XXXX----XXXXXX-----XXXXX-------XXXXXX-XXXXXX------XXXXXXX---------XXXXXXXXX------------------B-XXXXXXX|-----------XXXXf
----------------------XXX|----------------T-|------XXXX----------XXXXX------XXX--XXXXX----XXXXXX----XXXXXX-----XXXXXXX-XXXXXXX----XXXXXXXX--------XXXXXXXXXX--------------------XXXXTXX|X----------XXXXf
m---------------E-----XXX|X--------------E|-|-----XXXXX---------XXXXXX------XXXX-XXXXXX---XXXXXXX---XXXXXXX---XXXXXXXX-XXXXXXXX--XXXXXXXXX-------XXXXXXXXXXX--------------------XXXX|XX|XX---------XXXXX
XX--XXXXXXXXXXXXXXXXXXXXX|XXXXXXXXXXXXXXXX|X|XXXXXXXXXXXXXXXXXXXXXXXXXXXXXXXXXXXXXXXXXXXXXXXXXXXXXXXXXXXXXXXXXXXXXXXXXXXXXXXXXXXXXXXXXXXXX--XXXXXXXXXXXXXXXXXXXXXXXXXXXXXXXXoXXXXXXX|XX|XXXXXXXXXXXXXXXX
