---------------------------------------------------------B-------------------?---------XXXXXXX-------------------------------------------------------------------------?--------------------o-----------
-------BB--------------------------------------------------------------------------------------------------------------------------------------------------------M---------o------------------????????--
------------------M------------------------------------------------------------------------------------------------XXXX----------------------XX---------------------------------------------------------
-------------------------------------------------------------------T-----------------------------------T-------------------------------------------------------------------------------o----------------
-B-----------------------------------------------------------------|-----------------------------------|---------------------------------------------------M---------------------------o----------------
-----B-------------------------------------------------------------|-T-----o---------------------------|-------------------------------------------B---------BBXBBBBB-------------------B------T--------
-------B--------M------XXXX-----------------------------?----------|-|----T----------------------------|--------------------------XXXXXX-----------------------XX---------------------------???|???-----
------------------------------------------------------------------X|B|----|----------------------------|-BBBBBBB------------?------------------------T---------XXX-------------------------T---|------Xv
----------------------------------X-------------------------X----XX|-|---?|??????--X---------o-X-------|---------------------------------------------|---------XXXX-----T------------------|---|------Xf
-------------------------o--------XX---????????---------o--XX---XXX|-|----|-------XX-----------XX------|--?------------------------------------------|---------XXXXX----|------------------|-BB|BBBB--Xf
---------------X------------------XXX---------------------XXX--XXXX|-|----|---o--XXX-----------XXX-----|----M----------------------------------------|---------XXXXXX---|--------X---------|---|------Xf
--------------XX------------------XXXX-------------------XXXX-XXXXX|-|----|-----XXXX-----------XXXX----|---????????----------------------------------|---------XXXXXXX--|--X-----XX--------|---|------Xf
-------------XXX------------------XXXXX---------T-------XXXXXXXXXXX|-|----|----XXXXX-----------XXXXX---|------?--------------------------------------|----T----XXXXXXXX-|--XX----XXXX------|---|------Xf
-----------XXXXX----------------?-XXXXXX--------|------XXXXXXXXXXXX|-|----|---XXXXXX------T---XXXXXXX--|----------------------------------B----------|-T--|----XXXXXXXXX|-XXXX---XXXX------|---|------Xf
m----------XXXXX------E-----------XXXXXXX---X---|-----XXXXXXXXXXXXX|-|----|--XXXXXXX------|-EXXXXXXXXX-|-BBB-------X-----------------------------E---|X|--|----XXXXXXXXX|XXXXXX--XXXXX-----|---|------XX
XXXXXXXXX-XXXXXXXXXXXXXXXXXXXXXXXXXXXXXXXXXXXXXX|XXXXXXXXXXXXXXXXXX|-|----|-XXXXXXXX----XX|XXXXXXXXXXXX|-X---XXXXXXXXXXXXXXXXXXXXXXXXXXXXXXXXXXXX----|X|XX|----XXXXXXXXX|XXXXXXXXXXXXXXXXX-|---|XXX---XX
