---------------B---------------------------------------------------------------------------------------------------------M-----------------------B------------------------------------------------------
----------------------------------------------------------------------------------------------------------------------------------------------------------------------------------------------------B---
-X-------------------------------------------------------------------------------XX----------------------M----------------------------------------------------------------------------------------------
----T---------------------------------------------------------------------------------X------------------------------------------------------?--------------------------------B-------------------------
----|---------------X----------------------------------T----------------------------------------------------B---?-----------------------------------------------------------------X---------------------
----|--------------XX----------------------------------|---------------------------------------------T------------T-----------------------o-----------M------??-------BBBBBB-----XX---------------------
----|-------------XXX----------------------------------|---------------------------------------------|------------|-------------------------X-B--------------o------------------XXX---------------------
----|------------XXXX----------------------------------|---------------------------------------------|------------|------------------------XX--------------------------M-------XXXXX----------------X--v
----|------o----XXXXX-------------X--------------------|-----------------------?---------------------|----------o-|-----------------X-----XXX------T--------------------------XXXXXXX---------------XX-f
----|-----T----XXXXXX---------?--XX------T-------------|--------------------------------------------X|------------|---------XXX-----XX---XXXX------|-------------------------XXXXXXXXX--------------XXXf
----|--X--|---XXXXXXX-B---------XXX------|--------X----|--------------------------------X----------XX|-BB---------|------T--o-XXXXXXXXX-XXXXX------|------------------------XXXXXXXXXXX-------------XXXf
-X--|-XX--|--XXXXXXXX-----o----XXXX------|--------XX---|--------------------------------XX--------XXX|------------|-----X|--?-------XXXXXXXXX----??|?----------------------XXXXXXXXXXXXX------------XXXf
----|XXX--|-XXXXXXXXX---------XXXXX------|--------XXX--|-----------X-??????-------------XXX------XXXX|------------|------|XXXX------XXXXXXXXX------|-------XXXXXX---------XXXXXXXXXXXXXXX-----------XXXf
----|XXX--|XXXXXXXXXXX-------XXXXXX------|-------BXXXX-|-----------XX-----------------?-XXXX----XXXXX|------------|------|BBB--o--X-XXXXXXXXX------|---X---XX------------XXXXXXXXXXXXXXXXX----B-----XXXf
m--X|XXX--|XXXXXXXXXXXX-----XXXXXXX------|--------XXXXX|-----------XXX---------------E--XXXXX--XXXXXX|----E---E---|----E-|E------XX-XXXXXXXXX------|BBBXX--XXX----------XXXXXXXXXXXXXXXXXXX---------XXXX
XXXX|XXXXX|XXXXXXXXXXXXXXXXXXXXXXXXXXXXXX|XXXXX---XXXXX|-XXXXXXXXXXXXXXXXXX------XXXXXXXXXXXXXXXXXXXX|XXXXXXXXXXXX|XXXXXX|XXXXXXXXXXXXXXXXXXXX-----|XXXXXXXXXXXXXXXXXXXXXXXXXXXXXXXXXXXXXXXXXXXXXXXXXXXX
