----o---B----B-o------o------M??------------o----X-----------MB--------------------?------------------B?-XX-----------------o------------------------------o-o---?B-----E------------E------------E-----
----------------------------o------------------BXX-------------------------------o----------o-----------------o------oo------------------B--B---X-o--------------------------B??B-X---------------------
---------------o-----------B-XX-----------------BB?B-------------o----------------------X-X-o--------------------o----------X-------BXBX----o-----------o-?--BX--X----------------------------o---------
-----E--------------------------X-------------------------------------------??X-BB---MX-XXX------------BX-------------------B--?XX-?XX--o-----BB-E-B?--MBE--BBo-E--------X---MXBB------------------X----
-----------?---BX---BB----------B--------BBB---------------------------E-----------B-E---------------??BBX----o---BB--X----------BBX-?B------------------------------BB--?B?B?------E-------------------
---------EX--------BBBX--------------------------Eo-----o--X----o-----------B--BBBB-BB?X----------o-----XX---------------------X-------BXX------MBBX---------------------------------------X------------
----------o-BXo--E--M-X---o--------------------------------?B-----------o------------------------------------------------------------------E-------------?E-----X----------------------o--o-------------
--------BBXBX-BB-----XXBBX-MBBBBX----E--X---o---------------BBBX--BXXBB--B-----E----B--XX--X--E-o----MX----?XB-----------X----------------------------X-------XXXX----o-------------------------------v-
-----o-----XX---------X--Eo-----------XXX----?-BX---------------------------------o-----X-XX--------o------o-----------XXX--o---?MBX-------X------?BXBBX---ooo----X---B------B?BB---B?-----o----------f-
------o--?--oE---------X---o--------XXXX---o------------?-----------------------------BXE--oo------------?BXBX?B-X-----X---o-------MX-------X--------BMBB?B-?BB--E--------BX-------------------?BXX-?-f-
----?o---------o-------X------------XXX-?-XXo---------Bo--------o-----------o-----X-----X--?BXBBBBX-------E-----------X----XX---o----BBBX--o--------E--X---------o---------------o--BB?B----------o---f-
------BBBB-----oE-BX----B?-Bo-??X----X-----B----------------XXBE---T---T--B---B-BX-o--oo------X-----------?o----------o-----X-------E----o--o-X------------------------------o----E-------------------f-
-----------X--------BX------------?|X---E-----------XXX------o--------o----X------------T----XX---------------?XX----------o?-------o----------T----T-------X-----BBB-----------------------X--E------f-
---------XXX--T-------T----E--T----|X-XX--X------B-B-XXoXXX----T-------XX--XX--X--------|----XXT----X-XXXT--X--XXT-------T-X---T--oo--Xo----T--|-T--|---BBT--X--T-------T-----T---------T-XX----------f-
m?BX?B?X-XXXXX|-----XX|-XT-X--|--XXXXB----X--XX-------XXXXX-XXX|--X--XXXX--XXXXX-X-----XXXXXXXX|-----XXXX|XXXB-XX|-X---XX|EXX--|-------XXMXX|--|-|--X-XXXX|-XXX-|-XXXXXX|XX-XX|--XXXXX--|---XXXE-T-X--f-
XXX--X-XXX-XXXXX--XXXXXXXXXX-XXXXXXX-XX-XXX-XXXXXXXXXXXX--XXXXXXXXXXXXXXX-XXXXXXXX---XXXXX-XXXXXXXXXXXXXXXXX-XXXXXXX--XXXXXXXXXXXXXX--XXXXXXXXXXXXXXXXX-XXXXXXXXXXXXXXXXXX-XXXXXXXX--XXXXXXX--XXXXXXXXXX
