------------------o-------------------------?????----------B------------------------------------------------------------------------------------------------X-------------------------------------------
-----------------------------------------------------------------------------------------M---------------------------------B--------------------------------------------????----------------------------
-------------------------------------------------------------------------------------------------------------------------M-----------------------------------------------o------------------------------
-------------------------------T-B----o-????????------------------------------------T-------------B-------------------------------------------------------------------X----T----XXXXX-------------------
-------------------------------|------------T-----T---------------------------------|--------------------------------------------------------------------------------------|----------------------------
-------------------------------|-T-------T--|-----|---------------------------------|------X----M--------------------------------------------------------------------o-----|-X-------------------X------
-----------------------------B-|-|------?|?-|-----|--------------------------------X|-----XX-------------------------------M---------------T--------------------X----------|XX-T----------------XX------
-------------T------------T----|-|-------|--|-----|--------------------------------X|-T-XXXX------------------------?-----------------T----|-----o-------------XX----------|XX-|---M-----------XXXBBBBBv
------------o|------------|----|-|-------|-X|-----|--------------------------------X|X|-XXXX-X--------------------B----------------T--|----|------------------XXX---M-----X|XX-|--------------XXXX-----f
-------------|------------|----|-|-------|BX|BB---|--------------------------------X|X|XXXXX-XX------------------------------------|--|----|-------------?---XXXX--------XX|XX-|-------------XXXXX-----f
----T--------|------------|----|-|-------|-X|X----|--------------------------------X|X|XXXXX-XXX-----------------------------B-----|--|----|----------------XXXXX----X--XXX|XX-|------------XXXXXX---o-f
----|--------|------------|----|-|-------|-X|XX---|--------------------------------X|X|XXXXX-XXXX-------------------------X------T-|--|-X--|---------------XXXXXXT-----XXTX|XX-|-----------XXXXXXX-----f
----|--------|----X-------|X---|-|-------|-X|XXX--|--------------------------------X|X|XXXXX-XXXXX-----------------------XX------|-|--|-XX-|------X-------XXXXXXX|----XXX|X|XX-|----------TXXXXXXX-----f
----|--------|---XX-------|X---|-|---BBBB|-X|XXXT-|---------T--T-------------------X|X|XXXXX-XXXXXX---------------------XXX------|-|--|-XXX|----TXX------XXXXXXXX|---XXXX|X|XX-|X--------X|XXXXXXX-----f
m-o-|--------|--XXX-BBBB-X|X---|-|----BE-|-X|XXX|X|----E----|-E|----E------E------XX|X|XXXXX-XXXXXXX-------------------XXXX-----E|-|--|-XXX|----|XXE--E-XXXXXXXXX|--XXXXX|X|XX-|XX--o---XX|XXXXXXX-----X
XXXX|XXXXXXX-|-XXXXXXXXXXX|XXXX|-|--XXXXX|?X|XXX|X|XX----BBB|BB|BXXXXXXXXXXXXXXXXXXX|X|XXXXXXXXXXXXXXXXXXXXX--XXXX---XXXXXXXXXXXX|X|XX|XXXX|XXXX|XX----XXXXXXXXXX|XXXXXXX|X|XX-|XXXXXXXXXX|XXXXXXX-XXXXX
