----------------o----------------------------------------------------------------------------------------o--------------?---------B--B---------------------o------B--------------?----------------------
--------------------------------------------------------------------------M----------------------------------------------------------------------????---------------------------------------------------
----------------------o-------------------------BBBBBBBB-------------------------------------------------------------------?------------X-XXXXXXXX----------------o-?-----------------------------------
----------------------------------M----------------------------------------------------------------------------------------o----------------------------o-----------------------------------------------
-----------T-----------XXX--------------------------------T-------X------------------------------------------------------------X------------------------------------------------------------------------
----------T|---T---------------------------X-----------o--|-----------T---------X---------------------------------------------XX-T-------------o--------------------------------------X-----------------
-?--------||-?-|------------------------------------------|-----------|---------XX-------------------------------------------XXX-|-----------------------XT---------------------------------------------
----------||---|---BBBBBBBB-------BBBBB-------?---------??|??---------|X--------XXX-------------o---------------------------XXXX-|----------------------XX|--------------------------------------------v
----------||---|------------------------------------------|-----------|X--------XXXX----B-------------------------------T--XXXXX-|---------------------XXX|--------------------------------------------f
--M-------||---|---------X---T-------------------X--------|----------X|X--B-----XXXXX-------------X---------------------|-XXXXXX-|--------------------XXXX|---------------T---------------M------------f
----------||---|--------XX---|BBBB----X----------XX-------|---------XX|X--------XXXXXX----------------------------------|XXXXXXX-|-------------------XXXXX|---------------|------T---------------------f
----------||---|-------XXXX--|??------XX---------XXX------|--------XXX|X--------XXXXXXX--???????------------------------|XXXXXXX-|------------------TXXXXX|X--------------|------|------------T--------f
----------||--T|------XXXXXX-|--------XXX--------XXXX-----|-------XXXX|X--------XXXXXXXX------------------T----?-------X|XXXXXXX-|-----------------X|XXXXX|-----T---------|------|------------|--------f
----------||--||-X---XXXXXXXX|--------XXXX-------XXXXX----|------XXXXX|X------T-XXXXXXXXX-----T-----------|-----------XX|XXXXXXX-|----------------XX|XXXXX|-----|---------|--X---|------------|--------f
m-------E-||--||XX?-XXXXXXXXX|-E----EEXXXXX------XXXXXX---|-E---XXXXXX|X------|XXXXXXXXXXX-E--|-----------|----------XXX|XXXXXXX-|------E--------XXX|XXXXX|-----|---------|EXXXXX|-----------?|????----X
XXXXXXXXX-||-X||XXXXXXXXXXXXX|XXXXXXXXXXXXXXXXXXXXXXXXXXXX|----XXXXXXX|XXBXXXX|XXXXXXXXXXXXXXX|X----XX--XX|XXXXXXXXXXXXX|XXXXXXXX|XXXXXXXXXXXXXXXXXX|XXXXX|XXXXX|XXX--XXXX|XXXXXX|XXXXXXXXXXXX|XXXXXXXXX
