----o----------o------o------M--------------o---MXBBBB---BBBBBBB--------------------?BB----------------B-----X--------------o-E---BBX----------------------o-o----------E---------------------------E---
----------------------------o------------------BXX------------------------------Bo----------o-----------------o-----------------------------BXXXX-o--------------------------BX-------------------------
---------------------------B-X-------------------B---------------o------------X-------------o------------------B------------X----------X----------------o----BX--XB?BX------------------------o---------
-----E-----BX-----------------M-X-------E---------------BBBX-------------------------MX?---M-----------BXBBXX---------------B-B-XX-?----o---MXBBBX---B--------o-E-------BX---MBBB------E-----------X----
-----------?BBX------X----------B?B------B?----------------------------E----------B--E--------E-------BB------o-----?--------------------E-----------------E--------BB----XB-BX-----E-------------------
---------EX-------???BX--------------------------Eo-----oM-----Bo----------BB-BXBB----------------o-----------BBE--------------X-------------o--------?---------E--------MBX---------------X------------
--------?-o---o--E----XX--o---------------------------------------------o----------------------------BBX----------------------------------------------MX-?E-----------B-------MBB?-----o--o--?----------
------?B-----X----BBXXXX-XX-----------------o-----------B-------?BBB??-------------------------------B-XBBBBX-?-----------------------------------------------X----------------X----------------------v-
-----o-----XX---------XX--o-----------XX-----?XBBX--------------------------------o-----X-XX--------o------o-----------XX---o--B??BXX---?--X---BBB?--BBX---ooo----X----B----X-B-----BX-----o----------f-
------o?X---oE---------XX-----------XXX----o-----------------------M??B?----------------E--oo------------?BXX----------X---o---------------o----------BBX?-X-?---E--------B-------------------------?-f-
-----o--o------o--E----XX-----------XXX---X-o----------o--------o-----------o-----------X-----BBB?X-B?X---E------X-X--X----XB---o----B--X-----------E--X---------o---------------o-BXX?---------------f-
------BBB------oE--BX---B?BBo-?X-----X-B---BBX--------------X------------?BX---BBX-o--oo--------------Eo--?o------E---o-----X------------o--o----------?B--------------------oo---E-------------------f-
-----BBX---X--------------------?-?BX------------------E--X-----------o-??BX--oEX------------XXB-------------?BXX-----o----o--B-----o----------T----T----BB-------BB-E-----------T-T--------XX-E------f-
---T-----XXX---------T-X------T---XBX-T--T-------BT-T-?o-T-----T-----------X----BBBBBX--T--TBXX-T--BBBT-XT--X--XXT---------XT-----X---oo---?T--XXT--|---BB------T-------T-T-XXT--|-|-BB---X-----------f-
mXBX------XX-T-X-----|--XT-o--|--XXXXX|--|XB?XXX-X|-|-XX-|-----|--X--X-X----T-X--X------|-X|--oX|----X|-X|--Xo-XX|-X----X?EX|----?XX---XXMXX|---X|--XXXXE--X--XX|------X|-|-XX|--|-XXX---XXXXXXXXT-?--f-
XXXXXXXX---XXXXX---XXXXXXXXX-XXXXX-X-XXXXXX-XXXXXXXXXXX-XXXXXXXXXXX--XXXX-XXXXX-XX---XXXXXXXXXXXXXXXXXXXXXXXXXXXXXXX--XXX-XXXXXX-XXX--XXX--XXXXXXXXXXX-XXXXXXXXXXXXXXXXXXXXXXXXXXXX--XXXXXXXXX-XXXXXXXXX
