-------------------------------------------X-----------------------------------------------------------------------------------------M------------------------------------------------------------------
--------------------------------------------------------------------------------------------------------------------------------------------------------------------------------------------------------
---------------B-----------------------------------------------------------------------------------------??---------------------------B--------------------------------------------------B--------------
----------------------------------------o------------T-----------------------------------B------------------------------------------------------------------------------------B-------------------------
----M-----------------T----o-------------------------|-------------------------------------------------------------------------------------------------XXXXXXXX-----------------------------------------
----------------------|------------------------------|--B-T---????----------------T---------B--------X--------------------T------------B-------------------------X-------------X--------B----XXXXXXXX---
----------------------|------------------------------|----|-------X------X--------|-----------------XX----------X-----o---|----X---------------------------------XX-------------------------------------
----BBBBBBBB---B------|--X---------------------------|----|--------------XX-------|----------------XXX------------T-------|---XX---------------------------------XXX-----------------------------------v
----------------------|-XX------o--------------------|----|--------------XXX------|---------------XXXX------------|-------|--XXX--------------------------X------XXXX-------------X------o-------------f
-------------X--------|XXX---------------------------|----|---B------T---XXXX-----|--------------XXXXX------------|------?|?XXXX--------------------------XX-----XXXXX------------XX-------------------f
----o-T------XX-------|XXX--------------------X------|----|----------|--XXXXXX----|------X------XXXXXX------------|-------|XXXXX--------------------------XXX----XXXXXX-----------XXX------------------f
------|-?----XXX-----X|XXX------------XX-------------|----|----------|---XXXXXX---|--T---------XXXXXXX---X--------|-------|XXXXX---------o--------------X-XXXX-X-XXXXXXX----------XXXX--?T----B--------f
-B----|------XXXX---XX|XXX---------T--------------M--|----|----------|---XXXXXXX--|--|--------XXXXTXXX---------o--|------X|XXXXX-------------------????XX?XXXXXo-XXXXXXXX---------XXXXX--|-------------f
------|--o---XXXXX-XXX|XXX---------|--------X--------|----|----------|---XXXXXXXX-|--|-----?-XXXXX|XXX-o-----?----|-----XX|XXXXX----------------------XXXTXXXXXX-XXXXXXXXX--------XXTXXX-|-------------f
m-----|---???XXXXXXXXX|XXXE----B---|-o------XX---BBBB|----|----o-----|---XXXXXXXXX|--|------XXXXXX|XXX------------|----XXX|XXXXX----EE---------------XXXX|XXXXXXXXXXXXXXXXX-------XX|XXXX|--E----E-----X
XXX---|X-----XXXXXXXXX|XXXXXXXXXXXX|XXXXXXXXXXX---XXX|XXXX|XXXXB-----|XXXXXXXXXXXX|--|-----XXXXXXX|XXXXXXXXoXXXX--|---XXXX|XXXXXX------XXXXXXXXXXXXXXXXXX|XXXXXXXXXXXXXXXXXXXXX---XX|XXXX|XXXXX------XXX
