---o-E----------BBBX-----?BB--?BB---M--------------------MBX-??-M?B-?B------------------E-----M-o-o---o-----------------o-M?B-X-o-----------------o-----o---BB-B--BBB-----------o-------B-----??-X--oo--
--------------------X------o--------------------X--------------------------------o--BXXXBBB-o------------E--E-o-----o-------------------X---------B?-----------------?B?---E-XX-?-----------------------
---?BB?X------------X-BX----BBB-X---B-----------BB----X-----BX---o--BX---------X----??X-?BBXo------------------------------------------XX---------------o----?X-?B------------X---------------o----X----
-----E------------X-X-----------------MB-----BB--------BXX-XBB-BX---E----B---X----?E----------X--o------EX------------------------------o-----o----B-BB-X-----o---------------XXX-------XX?--------X----
-B----?BBB-X-?X-B----------------------X--XXX------XXB?BB------------------?o----------E---XXXX------B?XXX------------------------------------------------BX---o-------------o---o--------o-------------
------------------XX--B-E-----??-BB--XXXBBBB?-Bo----E---------------o-----------o-EM?BXX-XXX--X---E--?XBX?BB--------------X-----o--------------------o-------------------------MX-----------------------
---?----o---XX-----X------B----------------------------------o--?-X------o--XBX?B-XXXX?--------XX?BX--o----------o-----?XX---B-----T-------o------------??X------------BBB?BB?---B?B----?--o-------X----
------?X----?XB-B?B-XX-XX----B-X------------o---------------BX-------B-------XXE---MB---------E------------?X-----------E----------|X-------------------------X--------X-------X----------------------v-
-----o--BX--BX------XXo-----XBBX----MMBX-?XB?--------------XXX---------XX-----o---o-------X-------E-o----E-o-X-----o-BB-----o-X-?BXXX---?X---------BB?XBX--ooo-------------BB-B-B--BBB?XX--oo--BX--X--f-
-------o-----o--------X---E-BXX-XX----??B?---------o--Xo-----B?BX----XXXXX----------BXXX-oo-?o---XXX--?X---BXX----E-E---------oo---o-??BBXX------E-o----o---?BBo-X----E-?X--------------------B?XBoo--f-
---o---?BB?------o---------BXXX-------o-------------E--------------X-X---X--X?X-----XXXXBB--o------BBX-X--------------------------E------X------------------o------oBBX----o--o--X-Xo-------BX-X---X--f-
---BBB?------B-o-----BXX-B?-X--o------------M?--XE------o----------------o--BXBX---E----------?------BBo--------------X--------------o-o---------------------E------------------X-----B-?BB-------o-X-f-
-----X---X---oo----------X---X--o-------------T--B-XX-oo-------X-----------TXX-o-------o----T-------Bo---------------X---------X-BBX----------------BXo----------o----XXX---------o-----o------E------f-
---XXX-T-?o-----------XXo-------------------T-|---------?X--BXXXX----T-----|XX----T-X--?X---|X--T------o--------XX----T--o-T---XX--oXXo----XX--o-----E---X------X-------E-----M-----BT---?XXXXX-?T----f-
m-XXX-X|---TX----T--XXXXEX---X---T--XX--X-oX|-|-XB?-E-X---oXo-BXX----|-XXXXXX--BBB|XX---X-XXXX-X|--------X-MX-X--E-X-X|-XXX|--oXXXXXXXXXXXX-XE-XXo--X-----T----XXXX-X-----X--------oM|-X-X-XXXX-E|X---f-
XXXX-XXXXXXXX-XXXXXXXXXXXXXXXX-XXXXXXXXXX-XXXXXX-XXXXXX--XXXXXXXX-XXXXXXX-XXX--XXXXXX-XXX-XXXXXXXXXXX-XXXX--X-XX-XXX-XXXXXXXXXXX-XXXXXXXXX-XXXXX---XX---XXXXXXXXXXXXX--XXXX-XX-XX-XXXXXXXXXX---XXXX--XXX
