---?-------------------------------------------------------?-----------------------M-----------------?--------------------------------------------------------------------------------------------------
-----------------------------??????---------------------M----------------------------------------------------------o-----------------------------------------------o-----------------?------------------
---------------------------------------B-----------------------------??????-------------------------------------------------------------------------o--????????------------B--X-------------------------
----------------------------------------------T---------------------------------------------------------------BBBB------------------------------------BBo-----------------------------------------------
----------------------------------------------|------------X----------------------------------------------------????????-------------------------------------------X-----------------X------------------
-------------------------------------T--------|-----------XX------------X-------------------------------T---?---X------------T-----------B---------------------BBBBBBB--------------------XXXXXX--------
-------------------------------------|--------|----------XXX-----------XX--------o----------------------|------------oM------|--------------------------------------------------------------------------
-----------T-------------------------|--------|---------XXXX----------XXX---T-----------T---------------|---X----------------|---------T---------------------T-------XXXXX-----o-----------------------v
-----------|-----X------?------------|--------|-Bo-----XXXXX---------XXXX---|-----------|---------------|--------------------|---------|--------T---------B--|---------XX------------------------------f
------o----|----XX---------?---------|--------|-------XXXXXX-------oXXXXX---|X----------|-----B---------|--------------------|---------|------T-|------------|--------XXX------------------------------f
-----------|---XXX-------------------|--------|------XXXXXXX-------XXXXXX---|XX---------|---------------|--------------------|--------?|??????|B|X-----------|-------XXXX------------------------------f
-----------|--XXXX-------------------|--------|-----XXXXXXXX------XXXXXXX---|XXX--------|-----------T---|--------------------|---------|------|-|TX----------|------XXXXX-----------------------------Tf
-----------|-XXXXX-------------------|--------|----XXXXXXXXX-----XXXXXXXX---|XXXX-------|-----------|---|---------------?T---|---------|T-----|-||XX---------|-----XXXXXX---------B-------------------|f
-----------|XXXXXX----T--------------|--------|---XXXXXXXXXX----XXXXXXXXX---|XXXXX------|BBB--------|---|----------------|---|-T-------||-----|X||XXX--------|----XXXXXXX--------------------T--------|f
mE---------|XXXXXX----|------E-------|--------|--XXXXXXXXXXX---XXXXXXXXXX---|XXXXXX-----|-----------|X--|---EE-------E---|---|-|-------||--E--|X||XXXX----E--|---XXXXXXXX----------------?---|--------|X
X?XXXXXXXXX|XXXXXX----|-XXXXXXXXXX---|-XXXXXXX|XXXXXXXXXXXXX--XXXXXXXXXXXXXX|XXXXXXXXXXX|XX--XXXXXXX|XX-|XXXXXXXXXXXXXXXX|XXX|X|X----XX||XXXXX|X||XXXXXXXXXXX|XXXXXXXXXXXXX------------------|----MXXX|X
