--------------------------------------------------------------------------------------------------------------------------?-----------------------------------------------------------------------------
---------------------------BBBBBB----------o----------------X---------------------------------B----B--------------------------------------------------------------M-------------------------------X-----
-------------------------------------------------?????-----o-------------------------------------?-------------------------------------------------?----------------------------------------------------
-----------------------T--------------------------------------------------------------------------------------------------------------------------------M-----------------------------------------------
----------------------?|?-T-----T--------T--------------------------------------------------------------------------------------------------------------------T-----------------------------------------
-----------------------|--|-----|--------|X-------------------------MX--o--?-----BBBBB--------------------------------------------------X---------------------|-------------------M-------o-------------
-----T-----------------|--|-----|--------|X-------------------------XX-----B------------------------------------------------------------XX----------X---------|------------M----------------------------
-----|------T----------|--|-----|-------X|X------------------------XXX----------------?B-----------------------------------XX----???????XXX--------XX---------|----------------------------------------v
-----|------|----------|--|-----|-----BXX|X---------o-------------XXXX------X-------------X-X---------X-?---------------X---------------XXXX------XXX-----o---|----------------------------------------f
-----|------|----------|--|-----|-----XXX|X----------------------XXXXX----------------------XX-----T--XX---------------XX--------X------XXXXX----XXXX---------|---------------------------------------Xf
--X--|----X-|----------|--|-----|----XXXX|X------X--------------XXXXXX----------------------XXX----|--XXX-----T-------XXX-------XX------XXXXXX--XXXXX-----X---|-------T-----T--------?T-----o---------Xf
-----|??????|----------|--|-----|---XXXXX|X-----XX-------------XXXXXXX---o------------------XXXX---|--XXXX----|------XXXX------XXX------XXXXXXXXXXXXXX--------|-----BT|BTBB-|---------|---------------Xf
-----|------|-X--------|--|-----|--XXXXXX|X----XXX--------o---XXXXXXXX----------------------XXXXX--|--XXXXT---|---o-XXXXX-----XXXX------XXXXXXXXXXXXX---------|------||-|---|---------|---------------Xf
-----|------|XX----?-T-|--|-----|-XXXXXXX|X---XXXX----o------XXXXXXXXX----------------------XXXXXXo|--XXXX|X-T|----XXXXXX----XXXXX------XXXXXXXXXXXXX---------|------||-|---|X--------|---------XXX---Xf
m----|X-E-E-|XX----E-|E|--|-----|XXXXXXXX|X--XXXXX----------XXXXXXXXXX--E---------------E---XXXXXXX|--XXXX|XX||---XXXXXXX---XXXXXX------XXXXXXXXXXXXX---------|XXXXXX||-|---|-----E---|----------XX---XX
XXX--|X--XXX|XXXXXXXX|X|XX|XXXBB|XXXXXXXX|XXXXXXXXXXXXXXXXXXXXXXXXXXXXXXX--------------XXXXXXXXXXXX|--XXXX|XX||XXXXXXXXXXXXXXXXXXXXXXXXXXXXXXXXXXXXXX------XXX|XXXXXX||X|XXX|XXBXXBXXX|-X--X--XXXXXXXXXX
