--------------------------------------------------------------------------------------------------------------------------------------------------------------------X--------M--------------------------
-o------------------------------------------------------???????-----------------------------------------------------------------------------------------------------------------------------------------
--------------------------------------------------------------------------------X-----------------------------------------------------------------------------------------------------------------------
-------T--M---------------------------------------------------------------------------------------------------------------------------B---------------?????------------------T---------------o------M---
-------|----------------?-----------------------------------------------------------------------------------------------------------------------------X----------------X-----|--------------------------
-------|--------------------------------X-----------------------------------------------------------------T----------------------------------o-------XX-------M-------XX-----|-o------------------------
-------|B-------------------------------XX-----------------------------------------------------X----------|-----------------------------------------XXXXX------------XXX-----|------------oT------------
-------|--------------------------------XXX----------------------------------------------XXXX-XX-------o--|----------------------------------------XXXX---------XXX-XXXX-----|-----o-------|-----------v
-------|-----------------------------M--XXXX---o---------------------------------------------XXX----------|-----------------------------------M---XXXXX------------XXXXX-----|-T-----------|-----------f
-------|--------------------------------XXXXX-----------------------------------------------XXXX----------|--------------?-------T---------------XXXXXXX----------XXXXXX-----|-|-----------|-----------f
-------|---------------o----------------XXXXXX---------------o----BBBBBB-------------------XXXXX-----?----|----------------------|--------------XXXXXXX----------XXXXXXT-----|-|-----------|-----------f
-------|--------------------------------XXXXXXX-----------T------T------------------------XXXXXX----------|-------------------X--|-------------XXXXXXXX---------XXXXXXX|B----|-|-----------|-----------f
-------|--------------------------------XXXXXXXX-----T-?--|------|-----------------------XXXXXXX----------|------------------XX--|------------XXXXXXXXX--B-----XXXXXXXX|-----|-|-----------|------X----f
-------|---M----------------------------XXXXXXXXX----|----|------|----------------------XXXXXXXX----------|--X--------------XXX--|-----------XXXXXXXXXX-------XXXXXXXXX|-----|-|-----------|------XX---f
m--E---|--------------------------------XXXXXXXXXX---|E---|------|---------------------XXXXXXXXX----------|--XX------------XXXX--|--------X-XXXXXXXXXXX--E--EXXXXXXXXXX|-----|E|E----------|------XXX--X
XXXXXXX|XXXXXXXXXXXXXXXXXXXXXXXXXXXXXXXXXXXXXXXXXXX--|XXXX|XXXXXX|XXXXXXXXX-------XXXXXXXXXXXXXXXXXXXXXXXX|XXXXXX----XXXXXXXXXXXX|XX---o--XXXXXXXXXXXXXXXXXXXXXXXXXXXXX|----X|-|-XX-------X|XXXXXXXXXXXX
