---------------------------M------------------------------------------------------------X-----------------------------------------???-------------------------------------------------------------------
---------------------------------XXX-----------------------------------------------------------------------------o----------------------------------------------------------B---------------------------
------------M------------------o-----------------------M----------------?----------------------------------------------BBBB-----------------------------------------------------------------BBBBMBB-----
-----------------------------------o--------------o-------------------------------------------------------X---------------------------------------------------------------------------------------------
-------------M----o---------------B-----------------------------------------------------------------------------------------XXXX----------------------B-------------------------------------------------
-------------BBBBBBBBBB------------------------------------------------------------------------------------------------------------------------------------------------------------XXXXXXX----X-TXXXXXX-
-------------X--------X------------------------X-----------------------------------------------------------------------------------------------------???X???---------------------------------XX-|-------
-------------XX-------------------M------------XX-----------------------------X------------------------------------------------------B-----------------XX--------------o----------------T---XXX-|------v
-------------XXX-------------------------------XXX--------o----------------M-XXT----------M--------------------------------------------X---o----------XXX-------------------------------|--XXXX-|------f
-------------XXXX--------------------------X---XXXX-------------------------XXX|-----------------------------------------------X-------XX------------XXXX-------------------------------|-XXXXX-|------f
-------------XXXXX-----------------------------XXXXX-----------------------XXXX|---------------------T---------------o--------XX-------XXX----------XXXXX-------------------------------|XXXXXX-|------f
-------------XXXXXX----------------------------XXXXXX---------------------XXXXX|---------------------|-----------------------XXX-------XXXX-M------XXXXXX-------------------------------|XXXXXX-|---T--f
-------------XXXXXXX---------------------------XXXXXXX-----------------X-XXXXXX|--------------M------|----------------??????XXXX-------XXXXX----X-XXXXXXT------------------------------X|XXXXXX-|---|--f
-------------XXXXXXXX--------------------------XXXXXXXX----------------XXXXXXXX|---------------------|----------o----------XXXXX-------XXXXXX----XXXTXXX|-------------?---------------XX|XXXXXXB|---|--f
m--------E---XXXXXXXXXE-M--------E--------E----XXXXXXXXXE-E------------XXXXXXXX|----B-----EE---------|----------------X---XXXXXX-------XXXXXXX--XXXX|XXX|--------------------E-------XXX|XXXXXX-|E--|--X
XXXXXXXXXXXXXXXXXXXXXXXXXXXXXXXXXXXXXXX-----XXXXXXXXXXXXX-----XoXXXXXXXXXXXXXXX|---XXX-------XX--XXXX|XXXXXXXXXXXXXXXXXX-XXXXXXXXXX---XXXXXXXXXXXXXX|XXX|X-------XBXXXXXXXXXXXXXXXXXXXXX|XXXXXXX|XXX|--X
